find_verb	TN
whole_adj	TN
offer_verb	TP
know_verb	TN
able_adj	TP
happen_verb	TN
presence_noun	TP
grow_verb	TN
lord_propn	TN
beautiful_adj	edge-case
present_adj	TP
reason_noun	TP
house_noun	TN
truth_noun	TN
large_adj	TP
open_adj	TN
evening_noun	TN
age_noun	FN
keep_verb	TN
life_noun	TN
lady_noun	TN
first_adj	TN
back_adv	TN
glass_noun	TN
alone_adv	TN
word_noun	FP
course_noun	TP
remain_verb	TP
glad_adj	TN
enough_adv	TN
lip_noun	TN
work_noun	TN
water_noun	TN
fact_noun	TP
suppose_verb	TP
soon_adv	TN
break_verb	TN
short_adj	TN
look_verb	TN
home_adv	TN
â€™_verb	FP
even_adv	TN
son_noun	TN
make_verb	TN
effect_noun	TP
sort_noun	TP
change_verb	FN
question_noun	TP
bear_verb	TN
trouble_noun	TP
chance_noun	FN
idea_noun	TP
fall_verb	TN
one_noun	TN
lie_verb	TN
fine_adj	TP
step_noun	TN
world_noun	TN
mind_noun	TN
learn_verb	TN
want_verb	TN
true_adj	TN
miss_propn	TN
much_adv	TN
begin_verb	TN
look_noun	TN
hand_noun	TN
deal_noun	TN
servant_noun	FN
give_verb	TN
possible_adj	TP
real_adj	TP
arm_noun	TN
god_propn	TN
girl_noun	FP
wonder_verb	TN
right_adj	edge-case
week_noun	TN
thought_noun	TN
pay_verb	TP
stand_verb	FP
perhaps_adv	TN
leave_verb	TN
understand_verb	TN
party_noun	TP
marriage_noun	TP
pass_verb	TP
consider_verb	TP
sit_verb	TN
repeat_verb	TP
bed_noun	TN
come_verb	TN
letter_noun	TP
day_noun	TN
window_noun	TN
reply_verb	FN
certain_adj	FN
door_noun	TN
death_noun	TN
live_verb	TN
